####################################################################################################
# #     #     #  #                  #    #              #    #      #     #   #   #           #    #
# # # # # #####  # ################ #  # #              # #  #    # # # #   # # # # ######### # ####
# # # #       #  # #              # #  # #              # #  #    #  #  ### #   #   #     #   #    #
# # #   ##### #  # # ############ # # ## #              # ## #    # # # ### ######### ### # # #### #
#       #     #  # # #     #   ## # #                        #    # # #             #       #      #
## ######  ####  # # # # #   #  # # #                        #    # #  ## ######### ###### ## ######
#   #   #   # #  # # # # ######## # # ## #              # ## #    #  #            #         #     ##
#  #  #   #   #  # # # #          # #  # #              # #  #     #  ###########    # ######   #  #
#  ############  # # # ############ #  # #              # #  #     #  #    ##    #####  #   ###### #
#    #   #    #  # # #              #    #              #    #      #   ##    ##          #        #
#  #   #   #     # # ################ ######################## ################################### #
#  #   #   #                          #                                      #                     #
#                                                       #                                          #
#   ####### ##  # ####### # ################# ######### #################################### #######
#   #        #  # #     # #              #    #         #   #                              #       #
#   # ### # #   # # ### # #  ################ ######### # # # # # ##########   ############# ##### #
#   # ### # #  #  # ### # # #   #       #   # # #         #   # # #       #   #                  # #
#   # ### # ####  # ### # #   #     #  #  #  #  # ###### # # # #  # ######  ###### ############# # #
#   #     #       #     # #### ##  #  #  #  # # # #   # #   #   # #        #   #   # #  #        # #
#   ####### # # # ##### # #       # #   # #   #     #   # # # # # # # ## #   ### #     #  ###### ###
#            ###          # # ####   # #  #### ### # ### ##   #    # #   ###     ####  # # #   #   #
#   ####  # # #  #  # # #   #     #   #  #                # ## # # # # ##   #### #   ###   # # # # #
#      # #  #  # ###  ### # # # #   #   # # ### ######### #    # # # # #  # #    # #   # # # # # # #
#   # ###    # # ### #### #   # ######### #  #  # #       ###### # # # # #  # # # ####   # # # ### #
#   # # #  # #     ### #  # # ##        # #### # #  ### # #      # #   #  #   #   #   # ######   # #
#        #####  # #       ###   # ####### #  #  #  #   ## # #### ######## ########  # #  #   # # # #
#           #   ### # ##  # # # #       # # #     #  #  # #    # #              #   #  # # # # #   #
#   # #####        ####   #   # ####### #   ######  ###  ## #### # ############ #  # # # # # ##### #
#   #     #     ##   ## # # # #         # #        #   #  ###    #       #      # #    #   #     # #
#   # ### #  # # #   ###  # # ############# #######  #  #    ######################### ######### # #
#   # ### # ## ###   # #  ##   #    #  #  #     #   ###    #                                     # #
#   # ### # ##  # #  #    # ###  # ###  # ####### ##   ######################## ################ ###
#   #     # #     # #   # #     #   #                #                  #            #             #
#   ####### ####  # ###   # ########   ################################  #####  #####  #############
#                         #                                           # ##     #     # #           #
# ################################################################### # # ##### #### # # ######### #
#           #                                                       # # #              # #       # #
# #         #             ######################################### # # ###############  #  ###  # #
# #         #             ##   #   #   #   #     #   #   #   #   ## # #                 #  #   # # #
# #                       #  #   #   #   #   # #   #   #   #   #  # # ##################  #  # # # #
# #                       # ################## #################### # #   #   #   # #    #  #  # # #
# #         #             # #                                       # # # # # # # #   # #  #     # #
# #         #             # ######################################### # # # # # # ### # # # #####  #
#           #             #                                           # #   #   #     #            #
# ##################################################################### ############################
#                                                                                                  #
#     ##   ###  ##   # #          #  #         #     #   # #  # # ##    #  ### # ### #    #  # #   #
##  #    #        #      ##    #   #  #    #  #  #   ####     #  ## ####   # #   ###    #  #     # #
#                    #     # # #  #           #       ###     #  ##  ###      ###   ##  #  ###  #  #
##     #    # #          #             # #       ########## #  # ##   ##    #  #####       # # ### #
#            ### #  #  ### #     #     #    #        #####  # ##   #   ## # # ########  ####       #
#   #    #         ##  #   #    #      #         #      # ##   ## ###  ###    # ##     ###  ## #####
## #   # # # ##   ##         #         #    #        ###  ### ####  #     #     #  # ##      #     #
## #   ## #      #  #           # #      #           ##   # #  ###   #  # ###   # #   ## ####  #####
#     # # #          #        #   ###  #     ######### ##     # ###    ##   # ######   # ## ## #####
#             ###     ###  #    #   ###    #            # ##    ####  ##### #  ###    ####   # #####
#     # ##       ##     # #    #       # #  #         #  #### # #### ## #####   ###     ####   ### #
##   ## #    ##     #  #         # #  #  #           # #  #  ###     #     #### ##    ### ## # #   #
#  ##              #                        #        # ## ##   ###  ###  #  ### #### #    ###  # ###
#    ##              #  # #       ##        ##         ######    ## ##  ##    #   ## #   #    #    #
# #  #   #     # #      # # #        #  #      #     #  #####  # ## ###### ##   #   #      ####### #
#  # #         #          ###                        ##      #   ## ####  ## #   ##  ##   #######  #
# #   #          #     #   #     #        #   ########  #    ####   ####       ### #  ### #       ##
#         # #        #  #       ## #      #          # ##   # ###  ###  ##  # ###  ##  ####### #####
## #      ##  # ##   # ##   ##      #    #           # #  #     #       ##      #  ##  ######  #####
#  #           ##              ###     ## #           ##      # #       #  # ##   #  ##  #### ######
#     #   #   #     ##                               ##    #####  # ## #  #  #  #  #####  #        #
# # # #         #   #                   #   #  #     ###  ###### ###     #  #  #    ##### # #      #
# #     ##     #       ##   #   #     #         ##   #### # ##  ####  #  # # # #  ######           #
#       #                #   #            #           # ###     ##   ######    # ##  ##            #
#         #                       # #         #      ## ####  ##### ###      # ###   ##   ## ##### #
# #           #       #      #  #          #         ## ### #   ### ## # ##    ###  ## ##  ##      #
#        # #    #   #  ## # #       #                #   # # # # # # # # # # # # # # # # # #       #
##     # #           # #     #   #   #           #                                                 #
#      ###  # ###                                     # # # # # # # # # # # # # # # # # # # # # # ##
##  #     #     #     #  ##    #          # #                                                      #
##  #  #        #       #         ## #  ##           # # # # # # # # # # # # # # # # # # # # # # # #
#   #            #            # #          ###  #                                                  #
#  #       #  #  ##   #  #  #       #         # #     # # # # # # # # # # # # # # # # # # # # # # ##
#      #      ##     #   #     ##  # #  #    #  ##                                                 #
#    #   #        ## ##   #   #           #  #       # # # # # # # # # # # # # # # # # # # # # # # #
#    ##         #     #   #   ###    ##  # #                                                       #
#  #        #            #   #                 ##     # # # # # # # # # # # # # # # # # # # # # # ##
#     #           #    #  #       ##  ##                                                           #
#  #      ### #       #       #                ###   # # # # # # # # # # # # # # # # # # # # # # # #
#  # #     #                   #        #    # #                                                   #
#  #   #  #   # #    #  #  ###            ##          # # # # # # # # # # # # # # # # # # # # # # ##
#       #        ### #  #  ##  #  ##     # # #  ##                                                 #
#       #      #   ## ##  # # ##            #    #   # # # # # # # # # # # # # # # # # # # # # # # #
#      ##      # #    #  ## #   #   #   #   #                                                      #
#                # #  #     ##        #  #       #    # # # # # # # # # # # # # # # # # # # # # # ##
#     #   ##   #      ##  #    #  #    #                                                           #
#             #  # #  #### #   ## # #       ##  #    # # # # # # # # # # # # # # # # # # # # # # # #
##                     ##  #    ## #    ##  #  #                                                   #
##         # #  #    # #  ####  #    #                # # # # # # # # # # # # # # # # # # # # # # ##
# #        # ## #  #   # #    #                                                                    #
#  #       #        ##   ##                 #    #   # # # # # # # # # # # # # # # # # # # # # # # #
#                                                                                                  #
####################################################################################################
