##################################
#  #  #  #  #  #  #  #  #  #  #  #
#  #  #  #  #  #  #  #  #  #  #  #
##################################
#  #  #  #  #  #  #  #  #  #  #  #
#  #  #  #  #  #  #  #  #  #  #  #
##################################
#  #  #  #  #  #  #  #  #  #  #  #
#  #  #  #  #  #  #  #  #  #  #  #
##################################
#  #  #  #  #  #  #  #  #  #  #  #
#  #  #  #  #  #  #  #  #  #  #  #
##################################
#  #  #  #  ##########  #  #  #  #
#  #  #  #  ##########  #  #  #  #
##################################
#  #  #  #  ####  ####  #  #  #  #
#  #  #  #  ####  ####  #  #  #  #
##################################
#  #  #  #  ##########  #  #  #  #
#  #  #  #  ##########  #  #  #  #
##################################
#  #  #  #  #  #  #  #  #  #  #  #
#  #  #  #  #  #  #  #  #  #  #  #
##################################
#  #  #  #  #  #  #  #  #  #  #  #
#  #  #  #  #  #  #  #  #  #  #  #
##################################
#  #  #  #  #  #  #  #  #  #  #  #
#  #  #  #  #  #  #  #  #  #  #  #
##################################
#  #  #  #  #  #  #  #  #  #  #  #
#  #  #  #  #  #  #  #  #  #  #  #
##################################
