##################################
#  M  M  M  M  M  M  M  M  M  M  #
#  M  M  M  M  M  M  M  M  M  M  #
#MM#MM#MM#MM#MM#MM#MM#MM#MM#MM#MM#
#  M  M  M  M  M  M  M  M  M  M  #
#  M  M  M  M  M  M  M  M  M  M  #
#MM#MM#MM#MM#MM#MM#MM#MM#MM#MM#MM#
#  M  M  M  M  M  M  M  M  M  M  #
#  M  M  M  M  M  M  M  M  M  M  #
#MM#MM#MM#MM#MM#MM#MM#MM#MM#MM#MM#
#  M  M  M  M  M  M  M  M  M  M  #
#  M  M  M  M  M  M  M  M  M  M  #
#MM#MM#MM#MM#MM#MM#MM#MM#MM#MM#MM#
#  M  M  M  M##M##M##M  M  M  M  #
#  M  M  M  M##M##M##M  M  M  M  #
#MM#MM#MM#MM#MM#MM#MM#MM#MM#MM#MM#
#  M  M  M  M##M  M##M  M  M  M  #
#  M  M  M  M##M  M##M  M  M  M  #
#MM#MM#MM#MM#MM#MM#MM#MM#MM#MM#MM#
#  M  M  M  M##M##M##M  M  M  M  #
#  M  M  M  M##M##M##M  M  M  M  #
#MM#MM#MM#MM#MM#MM#MM#MM#MM#MM#MM#
#  M  M  M  M  M  M  M  M  M  M  #
#  M  M  M  M  M  M  M  M  M  M  #
#MM#MM#MM#MM#MM#MM#MM#MM#MM#MM#MM#
#  M  M  M  M  M  M  M  M  M  M  #
#  M  M  M  M  M  M  M  M  M  M  #
#MM#MM#MM#MM#MM#MM#MM#MM#MM#MM#MM#
#  M  M  M  M  M  M  M  M  M  M  #
#  M  M  M  M  M  M  M  M  M  M  #
#MM#MM#MM#MM#MM#MM#MM#MM#MM#MM#MM#
#  M  M  M  M  M  M  M  M  M  M  #
#  M  M  M  M  M  M  M  M  M  M  #
#MM#MM#MM#MM#MM#MM#MM#MM#MM#MM#MM#
